###############
#      #   451#
#      #      #
#  P   #      #
#      #      #
########   2  #
#         E   #
#             #
#             #
#         #####
#   1         #
#        #    #
#     2  #  X #
#        #    #
###############