###############
#      #     1#
#      #      #
#  P   #      #
#      #      #
###           #
#         E   #
#             #
#             #
#   ###########
#   6         #
#        #    #
#        #  X #
#        #    #
###############